Declaration in Stone -> Golden Parachute
Sphinx of Foresight -> Voidfish Hatchling
Carrion Feeder -> Brain Eater
Despise -> Violent Interrogation
Duress -> Torture
Dictate of Erebos -> War of Attrition
Great Furnace -> Klarg's Cannon
Keldon Marauders -> Really Wild Fire
Champion of Rhonas -> Magical Caterpillar
Lotus Cobra -> Podding Pod
Expansion -> Pyromancer's Amulet
Erratic Portal -> Very Erratic Portal
Panharmonicon -> Cheaper Panharmonicon
Conjurer's Closet -> Conjurer's Wardrobe
Sword of Light and Shadow -> Sword of White and Blue
Sword of Fire and Ice -> Sword of Blue and Black
Sword of Feast and Famine -> Sword of Black and Red
Sword of War and Peace -> Sword of Red and Green
Sword of Body and Mind -> Sword of Green and White
Ral, Storm Conduit -> The Trickster God
Rashmi, Eternities Crafter -> Rashmi's Apprentice
Worldkint -> One-Word Keywords
Hallowed Fountain -> Hallowed Fountain Temple
Watery Grave -> Watery Grave Temple
Blood Crypt -> Blood Crypt Temple
Stomping Ground -> Stomping Ground Temple
Temple Garden -> Temple Garden Temple
Godless Shrine -> Godless Shrine Temple
Steam Vents -> Steam Vents Temple
Overgrown Tomb -> Overgrown Tomb Temple
Sacred Foundry -> Sacred Foundry Temple
Breeding Pool -> Breeding Pool Temple
